********************
*<@>*7@@9***<8@@@@#*
*www*.ww+*-*w.wwwww*
*****w**+*+**w******
**-*****+*+*******-*
**1@@@#*.*.**;@@@@3*
**wwwww*w*w**wwwwww*
********************
****;@@@9***********
****wwww+****;@9****
********+****ww+*-**
*/*/*/*;3******1@3**
*w*w*w*ww******www**
********************
********************