********************
********/****<@@@>**
******-*w*-**wwwww**
******+***+*********
******+***+**<@@@>**
******.***.**wwwww**
******w***w*********
********/****<@@@>**
********w****wwwww**
********************
**********<@@@@@@>**
**********wwwwwwww**
********************
********************
********************